{
  "0":"10",
  "1":"9",
  "2":"8",
  "3":"3",
  "4":"2",
  "5":"1",
  "6":"5",
  "7":"4",
  "8":"6",
  "9":"7"
}