{
  "0":"17",
  "1":"16",
  "2":"14",
  "3":"15",
  "4":"11",
  "5":"12",
  "6":"13",
  "7":"22",
  "8":"23",
  "9":"21",
  "10":"20",
  "11":"18",
  "12":"24",
  "13":"19"
}