{
  "0":"28",
  "1":"29",
  "2":"38",
  "3":"36",
  "4":"37",
  "5":"35",
  "6":"34",
  "7":"30",
  "8":"31",
  "9":"25",
  "10":"33",
  "11":"27",
  "12":"26",
  "13":"32"
}