{
  "0":"17",
  "1":"16",
  "2":"14",
  "3":"15",
  "4":"11",
  "5":"10",
  "6":"12",
  "7":"13",
  "8":"9",
  "9":"8",
  "10":"3",
  "11":"2",
  "12":"1",
  "13":"5",
  "14":"4",
  "15":"6",
  "16":"7",
  "17":"18"
}